11111111111111111111111111111111
100000C0000000000000000000000001
100111100001111C01111111111110E1
10011110000111100111111111111001
10011110000111100111100001111001
10011110000111100111100001111001
10011111111111100000000111100001
10011111111111100000011110000001
10000000000111100001111000000001
10C00000000111100111100001111001
1000C000000111100111111111111001
1000C000000111100111111111111001
10000000000C00000P0000000000C001
11111111111111111111111111111111
