11111111111111111111111
10000000000000000000001
1111110111011011111E101
10000101010010100010001
111101010111101110111C1
10010101010000000000111
10010000010111101110011
10111111010100101011011
10000P00000101101001011
11111111110100101101011
1000P000000101100101C11
10111111111100111101111
10000000000000000000001
11111111111111111111111
