11111111111111111111111
100000000000000000C0001
11111101110110111111101
10000101010010100010001
111101010111C01110111C1
10010101010000000000111
10010000010111101110011
10111111010100101011011
10000000000101101001011
11C11111110100101101011
1000C000000101100101C11
101111111111001E1101111
10000000000000000000001
11111111111111111111111
