1111111111
1001C10001
1000000001
1000010011
1101EP10C1
1C01001011
1100100001
10001C1001
1111111111