1111111
1P1C001
1010101
1C1E1C1
1011101
100C001
1111111
