11111111111111111111111
1P000000000000000000001
11111101110110111111101
1C000101C10C101C001C001
111101010111101110111C1
10010101010000000000111
10C1000C010111101110011
1011111101010C101C11011
10000000000101101001011
1111111111C10C101101011
1000C000000101100101C11
1011111111110C111101111
1C0000000C00000000000E1
11111111111111111111111
