1111111111
1000000001
1C0C0C0C01
1C00000001
1011111111
1C00110001
1C000000E1
1C11111111
1P00000001
1111111111
