11111111111111111111111111111111111
1000000C000000000000000000000000001
1000111100001111C01111111111110E001
10001111000011110011111111111100001
10001111000011110011110000111100001
10001111000011110011110000111100001
10001111111111110000000011110000001
10001111111111110000001111000000001
10000000000011110000111100000000001
100C0000000011110011110000111100001
10000C00000011110011111111111100001
10000C00000011110011111111111100001
100000000000C00000P0000000000C00001
11111111111111111111111111111111111
